########################################
# #    #   # #   # # #     # #   # # # #
# ##### # # # ##### ##### # # # # # # # #
#     #   # #   #   #     #   #         #
##### # ### ##### ### ##### # ##### # ###
#       # #   #     #   #     #     #   #
# ### # # # ##### ### # # # ### ##### ###
#   # #   #   #     #   #   #   # # #   #
# ### # ##### # ### ##### ##### # # ### #
#     #   #     #     #     # # #   # # #
# # # # # # ### ##### # ### # # ### # # #
# #   # #   #     # # #   # #   #     # #
# # ##### # ### # # # # # # ### ### ### #
#   #       #   #   # #     #     # #   #
##### ##### ### ##### ### ### ### # ### #
#   #         # #   # #     # #   # # # #
# ### ### ##### ### # ### ### # ### # # #
#   #     #   #   # #   # #   #     #   #
# ##### ### ### ##### ### ##### ### # ###
#     #   #       #   #   #     #     # #
# ### # ### # ### # ### ##### ### ##### #
# #   # #   #   # # #   #   #   #     # #
# ##### ##### ##### ##### ##### ##### #
#                                   # #
# # # # # # # # # # # # # # # # # # # #
########################################
